1111111111111111111111111
1111111111111111111111111
1111100011111111100011111
1110000000111110000000111
1000000000001000000000001
0000021200000000021200000
0002111112000002111112000
0011111111102011111111100
1111111111111111111111111
1111111111111111111111111