1111111114114111111111111
4111111110223411111111111
3411111100002411111111111
0111114200000214111111111
2114110002100003411111111
0043200000110002341111111
0000000004111000011141111
0220000211111100000000000
0000001111111140000002000
1114111111111111111111111