1111111111111111111111111
1111111111111111111111111
1111111111111111111111111
0010000010000010000010000
0020000020000020000020000
0000000000000000000000000
0000210000212000010000000
1111111111111111111111111
1111111111111111111111111
1111111111111111111111111