1111131111144133111311111
0411001110022000116211100
0311201400000000240011100
0010002300000000030041000
0010000000001020020004000
0040000000201000000003200
0000000000004000000000000
0000001200041000020002200
0000011000011100000000000
1111111144111111441111141