1111111111441114111111441
0011100000000000020000000
0011402000020200000002000
0004000000000000000000000
0000000000111110000041110
0002000004111111020014410
0000000001111111000000000
0001000011111111400002000
0011100041111111100000000
1111111111111111111114111