1111111111111111111111111
0000000001111111111111111
0000000201111111111111111
0000000001111111100011111
0000201001111110000000111
0000011001111000000000001
0200011000000000001020000
0000111000000002111110000
0011111000000011111111002
1111111111111111111111111