1111111111111111111111111
0111000000000000000001110
0111000000005000000001110
0010000120000000210000100
0000200012200022100020000
0000000001122211000000000
0000000000011100000000000
0000000022000002200000000
0000000000000000000000000
1111111111111111111111111