1111111111111111111111111
1111111111111111111111111
1343111343111344111343111
0030020030020030020030000
0020000020000020000020000
0000000000000000000000000
0000240000242000040000000
1114411114411114411114411
1111111111111111111111111
1111111111111111111111111