1111111111111111111111111
0000000111111110002000111
0000000111111110000002111
0001000011111120000000201
0001000000110000001000000
0021120000000000001000000
0011100000000000011100000
0011111000000001111100000
0111111112002111111112000
1111111111111111111111111