1113111111111113111311111
0000000111111110002000111
0000020144111110000002341
0001000033111420000000203
0001000000130000204000000
0021120000000000001000000
0011100000000000011400020
0011114000000004411100000
0111111412002111111112000
1111111111111111111111111