1111111111111133111111111
0000114430000022000001111
0000003000220000000200341
0000000000000000000022031
0200000000000000000000000
0000000000000011000000000
0011400022001111442000000
0111111000011111111100000
1111111111111111111112200
1111111111111111111111111