1111111111111144111111111
0000111110000022000001111
0000004000200000000200411
0000000000000000000020011
0200000000000000000000000
0000000000000011000000000
0011400022001111442000000
0111111000011111111100000
1111111444411111111112200
1111111111111111111111111