1111111111111111111111111
1111111111111111111111111
1411111411111411111411111
0040020040020040020040000
0020000020000020000020000
0000000000000000000000000
0000210000212000010000000
4414414414414414414414411
1111111111111111111111111
1111111111111111111111111