3311113113441113111311341
0011100000000000020000000
0014402000020200000002200
0003000000000000000000000
0000000000111110000041110
0002000004111111020013410
0000000001111111000000000
0001000011111111400002200
0011100041111111100000000
1111111111111111111114111