1143111331111111111111111
0000000021111111111111111
0000000201111111113311111
0000000004111111100011111
0000201001111140000000131
0000044001411000000000004
0200011000000000004020000
0000111002000002111110000
0011114000002011111111002
1111111111114111111111111