1111111114111111111111111
1111111110201111111111111
1111111100000411111111111
0111114200000211111111111
2111110002100001111111111
0041200000110002111111111
0000000004111000011141111
0000000211111100000000000
0000001111111140000002000
1114111111111111111111111