1411111114111111111111111
0000000000000011111111111
0000002000000211111111111
1111114111120011111111111
1111111111400211111111111
1111111111120041111111111
1111111111100211141111141
1111111111120000020000000
1111111111100000000000000
1111111111111111111114111