1111111111111111111111111
0000111110000022000001111
0000001000000000000000111
0200000000000000000000000
0000000000000011000000000
0011100022001111112000000
0111111000011111111100000
1111111111111111111112200
1111111111111111111111111