1111111111111111111111111
1111111111111111111111111
1111102011111111102011111
1140000000411140000000411
1000000000001000000000001
0000024200000000024200000
0002411142000002411142000
0011111111102011111111100
1111111111111111111111111
1111111111111111111111111