1111111111111111111111111
1111113111111111113111111
1111100031111111100031111
1142000002411142000002411
1000000000003000000000001
0000024200000000024200000
0002411142000002411142000
0011111111102011111111100
1111111111111111111111111
1111111111111111111111111