1111111111111111111111111
4111111004111111001111111
0411110000411110004111111
0001000220001000200411110
0006000000006000000001000
0000000000000000000006000
0000000000000000000000000
0000000000000000000002200
0220004444000222004400000
0000111111110000011110000
