1111111111111111111111111
1111111001111111001111111
0111110000111110001111111
0001000220001000200111110
0006000000006000000001000
0000000000000000000006000
0000000000000000000000000
0000000000000000000002200
0220001111000222001100000
0000111111110000011110000
