01 01 13 13 13 13 13 13 13 13 13 13 13 13 13 13 13 13 13 13 13 13 13 01 01 10 10 10 10 10 10 10 10 10 10 10 10 10 10 10 10 10 10 10 10 10 00 00 00 01
00 00 00 13 13 13 13 00 00 13 13 13 13 00 13 13 13 13 13 13 13 13 13 00 00 02 02 02 02 02 02 02 02 02 02 02 02 02 02 02 02 02 02 02 02 02 00 00 00 00
00 00 00 13 00 13 00 00 00 00 13 13 13 00 00 13 13 13 13 00 00 13 13 00 00 02 02 02 02 02 02 02 02 02 02 02 02 02 02 02 02 02 02 02 02 02 00 00 00 00
00 00 00 00 00 13 00 00 00 00 13 13 00 00 00 00 13 13 00 00 00 00 13 00 00 00 00 00 00 00 00 00 00 00 00 00 00 00 00 00 00 00 00 00 00 00 00 00 00 00
00 08 00 00 00 00 00 04 00 00 13 13 06 00 00 00 00 13 00 00 00 00 13 00 00 00 00 00 00 00 00 00 00 00 00 00 00 00 00 00 00 00 00 00 00 00 00 00 02 02
00 08 06 00 00 00 00 00 00 06 00 13 00 00 00 00 00 13 00 00 00 00 00 00 00 07 00 00 00 00 11 00 00 00 00 00 00 00 00 00 00 00 11 00 00 00 00 00 02 02
00 00 00 00 00 00 00 00 00 00 00 00 00 04 00 00 06 00 00 00 00 00 00 00 00 07 00 00 00 00 11 00 00 11 00 00 00 00 00 00 00 00 11 00 00 11 00 00 00 00
00 00 00 00 00 00 00 06 00 00 00 00 00 00 00 00 00 00 00 00 00 00 00 00 00 07 00 00 00 11 11 11 00 11 00 00 00 11 00 00 00 00 11 11 00 11 00 00 00 00
02 02 02 02 02 02 02 02 02 02 02 02 02 02 02 02 02 02 02 02 02 02 02 00 00 11 00 11 11 11 11 11 00 11 00 00 11 11 11 00 00 11 11 11 11 11 00 00 00 00
02 02 02 02 02 02 02 02 02 02 02 02 02 02 02 02 02 02 02 02 02 02 02 04 04 11 11 11 11 11 11 11 11 11 00 00 11 11 11 11 11 11 11 11 11 11 00 00 00 01
01 01 10 10 10 10 10 10 10 10 10 10 10 10 10 10 10 10 10 10 10 10 10 09 00 00 00 00 00 00 00 00 00 00 00 00 00 00 00 00 00 00 00 00 00 00 09 00 00 00