01 12 00 00 12 00 00 12 00 00 12 00 00 12 00 00 12 00 00 12 00 00 12 00 00 12 00 00 12 00 00 12 00 00 12 00 01 12 00 01 12 00 00 12 00 00 12 00 10 01
00 00 00 06 06 00 06 06 06 06 06 06 06 06 06 06 06 06 06 06 06 06 06 06 06 06 06 06 06 06 06 06 06 06 06 06 06 00 00 06 04 00 06 00 06 06 06 00 02 02
00 00 00 06 00 02 00 06 06 06 06 06 06 06 06 06 06 06 06 06 00 00 00 06 06 06 06 06 06 00 00 06 06 06 06 06 06 00 00 06 00 00 06 00 00 06 06 00 02 02
00 00 00 00 02 02 02 00 06 06 06 00 06 00 06 06 06 00 06 00 02 02 02 00 06 06 06 00 00 02 02 00 00 06 06 06 06 00 00 06 00 00 06 04 02 02 06 00 02 02
00 00 00 02 02 00 02 02 00 06 00 02 00 02 00 06 00 02 00 02 00 00 00 02 00 00 00 02 02 00 00 02 02 00 00 00 06 04 02 06 04 02 06 04 02 02 00 00 02 02
00 00 00 02 00 06 00 02 02 00 02 02 02 02 02 00 02 02 02 00 06 06 06 00 02 02 02 00 00 06 06 00 00 00 00 00 06 04 02 06 04 02 06 04 02 02 00 00 02 02
00 00 00 00 06 06 06 00 02 02 02 00 02 00 02 02 02 00 00 06 06 06 06 06 00 00 00 06 06 06 06 06 06 06 06 06 06 00 00 06 00 00 06 04 02 02 06 00 02 02
00 00 00 06 06 06 06 06 00 02 00 06 00 06 00 02 00 06 06 06 06 06 06 06 06 06 06 06 06 06 06 06 06 06 06 06 06 00 00 06 00 00 06 00 00 06 06 00 02 02
00 00 00 06 06 06 06 06 06 00 06 06 06 06 06 00 06 06 06 06 06 06 06 06 06 06 06 06 06 06 06 06 06 06 06 06 06 00 00 06 04 00 06 00 06 06 06 00 02 02
01 12 00 00 12 00 00 12 00 00 12 00 00 12 00 00 12 00 00 12 00 00 12 00 00 12 00 00 12 00 00 12 00 00 12 00 01 12 00 01 12 00 00 12 00 00 12 00 10 01
07 00 00 00 00 00 00 00 00 00 00 00 00 00 00 00 00 00 00 00 00 00 00 00 00 00 00 00 00 00 00 00 00 00 00 00 00 00 00 00 00 00 00 00 00 00 00 00 00 09