01 01 01 01 01 01 01 01 01 01 01 01 01 01 01 01 01 01 01 01 12 00 00 00 00 10 01 00 00 00 00 00 01 01 01 01 01 01 01 01 01 01 01 01 01 12 00 00 00 10
06 00 00 00 00 00 00 00 00 00 00 00 02 00 00 00 00 00 00 00 00 00 06 00 00 00 00 00 00 00 00 00 00 00 00 01 01 00 00 00 00 04 01 04 00 00 00 00 00 00
00 00 00 02 00 00 00 00 00 02 00 00 02 00 00 00 00 00 02 00 06 00 00 00 00 00 00 00 00 00 00 02 00 00 00 00 03 00 00 00 00 00 01 03 00 00 00 00 00 00
00 00 06 02 00 00 00 00 00 02 00 00 00 00 00 00 00 00 02 00 00 00 02 00 00 00 00 00 00 00 00 00 00 00 00 00 01 00 00 00 00 00 00 01 00 00 00 00 00 00
00 00 00 00 00 00 00 00 00 00 00 00 00 00 00 02 00 00 06 00 00 00 00 00 02 00 00 00 02 02 00 00 00 00 00 00 00 00 00 00 00 00 00 01 00 00 00 00 00 00
02 00 00 00 00 00 00 00 00 00 00 00 00 00 00 02 00 00 00 00 02 00 00 00 00 00 00 00 02 00 00 00 00 00 00 00 00 00 00 01 00 00 00 00 00 00 00 00 00 00
02 00 00 00 00 00 00 00 00 06 00 00 00 00 00 00 00 00 02 00 00 00 00 00 00 00 00 00 00 00 00 00 00 00 00 00 00 00 01 01 00 00 00 00 00 00 00 00 00 00
00 00 00 00 00 00 02 00 00 00 00 00 02 00 00 00 00 00 02 00 00 00 00 00 00 00 00 00 00 00 00 00 00 00 00 00 00 04 01 01 00 00 00 00 00 00 01 00 00 00
00 00 00 00 00 00 02 00 00 00 00 06 02 00 00 00 00 00 00 00 00 00 00 00 00 00 00 00 00 00 00 00 00 00 00 04 01 01 01 01 01 00 00 00 01 03 05 01 00 00
01 01 01 01 01 01 01 01 01 01 01 01 01 01 01 01 01 01 01 01 01 00 01 00 01 00 01 00 01 00 01 00 01 01 01 01 01 01 01 01 01 01 01 01 01 01 01 01 01 01
00 00 00 00 00 00 00 00 00 00 00 00 00 00 00 00 00 00 00 00 00 00 00 00 00 00 00 00 00 00 00 00 00 00 00 00 00 00 00 00 00 00 00 00 00 00 00 00 00 00