01 01 01 01 01 00 03 01 01 01 01 01 00 00 00 00 00 01 00 00 00 00 00 00 00 01 01 00 00 01 04 01 01 01 01 04 03 03 01 01 04 03 01 01 01 00 00 01 01 01
00 00 00 00 00 00 02 00 01 01 00 00 00 00 00 00 00 00 00 00 00 00 00 00 00 00 00 00 00 00 00 00 03 01 01 00 00 00 00 06 00 00 00 00 06 00 06 00 00 00
00 00 00 00 02 00 00 00 00 01 00 00 02 02 00 00 02 06 00 00 00 00 00 00 00 00 00 00 00 00 00 00 00 01 00 00 00 00 00 06 00 00 00 00 06 00 06 00 02 00
00 00 02 00 00 01 00 02 00 03 00 00 00 00 00 00 00 00 00 00 02 00 00 00 00 02 00 00 00 00 00 00 00 01 00 02 00 00 00 06 00 02 02 00 06 00 00 00 00 00
00 00 00 00 04 01 00 00 02 00 00 02 00 00 06 00 00 00 00 00 00 00 00 00 00 00 02 00 00 00 00 00 00 00 00 00 00 00 00 00 00 00 00 06 00 02 02 00 00 00
00 00 00 00 04 01 00 00 00 02 00 00 00 00 00 00 00 00 02 00 00 00 00 02 00 00 00 00 00 00 00 00 02 00 00 00 00 02 00 00 00 00 00 06 00 02 02 00 00 00
00 02 00 00 01 01 00 00 00 00 00 00 00 00 00 00 06 00 00 00 00 00 00 00 00 00 00 00 00 00 00 00 00 00 00 00 00 00 00 01 00 00 00 00 00 00 00 00 00 00
00 00 00 01 01 01 01 00 00 01 00 00 00 00 02 02 00 00 00 00 00 00 00 00 00 00 00 00 00 00 00 00 00 00 00 00 00 04 01 01 01 00 00 00 00 00 06 00 00 02
00 00 01 04 01 01 01 05 01 01 00 00 00 00 00 00 00 00 00 00 00 00 00 00 00 00 00 00 00 00 02 00 00 00 00 00 01 01 01 01 01 01 00 00 04 00 06 00 00 00
01 01 01 01 01 01 01 04 01 01 01 01 00 01 00 03 03 01 01 04 01 03 00 00 01 01 00 00 01 00 00 00 00 01 01 01 01 01 01 01 01 01 01 01 01 01 00 01 00 01
00 00 00 00 00 00 00 00 00 00 07 07 00 00 00 00 00 00 00 00 00 00 09 08 00 00 00 00 00 00 00 00 00 00 09 00 00 00 00 00 00 00 00 00 00 00 00 00 00 00