01 01 01 01 01 01 13 13 04 01 01 01 01 04 03 01 03 00 00 01 01 01 04 00 00 00 00 00 01 01 01 13 13 13 13 13 13 13 13 00 04 01 01 01 01 01 01 01 01 01
04 01 01 01 01 00 00 00 00 00 00 01 01 03 00 00 00 00 00 00 02 00 00 00 00 00 00 00 00 00 01 00 00 00 00 00 00 00 00 00 04 01 01 01 00 00 00 00 00 03
00 00 00 00 00 00 10 10 00 00 00 00 01 00 00 00 00 00 00 00 02 00 02 00 00 00 02 00 00 00 00 10 10 10 10 10 10 10 10 00 00 01 03 01 02 00 00 00 00 00
00 00 00 00 00 00 02 02 00 02 00 00 00 00 00 00 00 02 00 00 02 00 00 00 00 00 00 00 00 00 00 00 00 00 00 00 00 00 00 00 00 00 01 00 00 00 00 00 00 00
00 00 00 00 02 00 00 00 00 02 00 00 00 00 00 00 00 00 00 00 00 00 00 00 00 00 00 00 00 00 00 00 00 00 00 00 00 00 00 00 00 00 00 00 00 00 00 00 00 00
02 02 02 02 00 00 00 00 00 02 00 00 00 00 00 00 02 00 00 00 00 00 00 00 00 00 00 00 00 00 00 00 00 00 00 00 00 00 00 00 00 00 00 00 00 00 00 00 00 00
02 00 00 00 00 00 00 00 00 02 00 00 02 00 00 02 00 04 03 00 00 02 02 00 00 01 00 00 00 00 00 00 00 00 00 00 00 00 00 00 00 00 00 00 00 04 02 00 00 00
00 00 00 00 01 01 01 01 01 01 00 08 02 00 02 00 04 04 04 00 00 02 02 00 01 01 02 02 00 00 00 10 10 10 10 10 10 10 10 00 00 00 00 00 04 01 00 02 00 00
00 00 01 01 01 01 01 01 01 01 01 08 00 00 00 04 04 04 04 01 05 00 00 03 01 01 02 02 00 00 00 00 00 00 00 00 00 00 00 00 00 00 00 04 01 01 01 00 02 00
04 04 01 01 01 01 01 01 01 01 01 01 00 00 00 04 04 04 04 01 00 00 03 01 01 01 04 01 00 04 00 11 11 11 11 11 11 11 11 00 00 00 04 01 01 01 01 01 01 01
00 00 00 00 00 00 06 00 00 00 00 00 00 00 00 00 09 00 00 00 00 00 00 00 00 06 00 00 00 07 00 00 00 00 06 00 00 00 00 00 09 00 00 00 00 00 00 00 00 00