00 00 00 01 00 00 00 01 01 03 00 00 00 00 00 00 01 00 00 01 01 01 04 01 01 03 01 04 01 01 01 01 13 13 01 01 03 01 01 01 01 01 04 01 01 03 01 01 01 01
00 00 00 00 02 06 02 00 00 00 00 00 01 01 00 00 00 00 00 00 00 00 00 00 00 00 00 00 01 01 01 00 00 00 04 01 05 00 00 03 01 00 00 01 00 00 00 01 00 00
00 00 00 00 00 00 02 00 05 00 00 00 00 00 04 00 02 00 00 02 00 00 00 00 02 00 00 00 00 01 00 00 00 00 00 04 00 00 00 00 01 00 00 00 00 00 00 01 00 00
00 00 02 00 00 01 00 00 00 00 00 00 02 00 00 00 00 00 00 00 00 00 00 00 00 00 00 00 00 01 00 00 00 02 00 01 00 00 00 00 03 00 00 00 00 00 00 00 00 00
00 00 00 00 01 01 00 00 01 00 00 02 00 00 00 00 04 00 00 00 00 00 00 00 00 01 00 00 00 01 00 00 00 00 00 01 00 00 00 00 00 00 00 00 00 00 00 00 00 00
00 00 00 00 00 01 00 00 00 00 00 00 00 00 00 02 04 00 00 00 00 00 00 00 01 01 00 00 00 00 00 00 00 00 00 03 00 00 00 02 00 00 00 00 00 00 00 00 00 00
00 02 00 00 00 00 00 00 00 02 00 00 00 00 00 00 00 00 00 00 00 02 00 00 01 01 00 02 00 00 00 00 00 00 00 00 00 00 00 00 00 00 00 00 00 00 00 00 00 00
02 02 00 00 02 02 00 00 02 00 04 00 00 00 00 00 00 00 00 00 00 00 00 01 01 01 00 00 00 06 00 02 00 00 00 00 00 02 00 00 01 00 02 00 00 00 00 02 02 00
00 00 00 00 00 00 00 00 00 00 04 00 00 00 00 00 00 00 00 00 00 00 01 01 01 01 00 00 00 06 00 00 00 00 00 00 00 00 00 00 01 00 00 00 00 00 00 00 00 00
04 01 01 00 00 12 00 00 00 00 00 00 00 02 02 00 10 00 00 00 01 01 01 01 01 01 00 00 00 06 00 00 00 00 00 06 00 00 00 01 01 00 00 00 02 00 02 00 00 00
00 00 00 00 00 00 00 00 00 00 07 00 00 00 00 00 09 00 00 00 00 00 00 00 00 00 00 00 00 00 00 00 10 10 00 00 00 00 00 00 00 00 00 00 00 00 00 00 00 00