01 01 01 01 01 00 01 01 01 01 01 00 01 01 01 01 01 00 01 01 01 01 01 00 01 01 01 01 01 00 01 01 01 01 01 00 01 01 01 01 01 00 01 01 01 01 01 01 01 01
00 01 04 04 04 00 00 00 00 00 00 00 00 00 01 04 04 04 00 00 00 00 00 00 00 00 00 00 00 01 03 03 03 00 00 00 00 00 00 00 00 00 00 00 00 00 00 04 04 04
00 00 01 03 04 00 00 00 00 00 00 00 00 00 00 01 03 04 00 00 00 00 00 00 00 00 00 00 00 00 01 03 03 00 00 00 00 00 00 00 00 00 00 00 00 00 00 04 04 00
00 00 00 01 04 00 00 00 00 00 00 00 00 00 00 00 01 04 00 00 00 00 00 00 00 00 00 00 00 00 00 01 03 00 00 00 00 00 00 00 00 00 00 00 00 00 00 04 00 00
00 00 00 00 01 00 00 00 00 00 00 00 00 00 00 00 00 01 00 00 00 00 00 00 00 00 00 00 00 00 00 00 01 00 00 00 00 00 00 00 00 00 00 00 00 00 00 00 00 00
00 00 00 00 00 00 00 00 00 00 01 00 00 00 00 00 00 00 00 00 00 00 00 00 01 00 00 00 00 00 00 00 00 00 00 00 00 00 00 01 00 00 00 00 00 00 00 00 00 00
00 00 00 00 00 00 00 00 00 01 04 00 00 00 00 00 00 00 00 00 00 00 00 01 04 00 00 00 00 00 00 00 00 00 00 00 00 00 01 04 00 00 00 00 00 00 00 00 00 00
00 00 00 00 00 00 00 00 01 03 04 00 00 00 00 00 00 00 00 00 00 00 01 03 04 00 00 00 01 00 00 00 00 00 00 00 00 01 03 04 00 00 00 00 00 00 00 00 00 00
00 00 00 00 00 00 00 01 04 04 04 00 00 00 00 00 00 00 00 00 00 01 04 04 04 00 00 00 00 00 00 00 00 00 00 00 01 03 03 04 00 00 00 00 00 00 00 00 00 00
01 01 01 01 01 00 01 01 01 01 01 00 01 01 01 01 01 00 01 01 01 01 01 00 01 01 01 01 01 00 01 01 01 01 01 00 01 01 01 01 01 00 01 01 01 01 01 00 01 01
00 00 00 00 00 00 00 00 00 00 00 00 00 00 00 00 00 00 00 00 00 00 00 00 00 00 00 00 00 00 00 00 00 00 00 00 00 00 00 00 00 00 00 00 00 00 00 00 00 00