01 01 01 01 01 01 01 01 01 01 01 01 01 01 01 01 01 01 01 01 01 01 01 01 01 01 01 01 01 01 01 01 03 01 01 03 03 01 03 01 01 01 01 01 00 00 00 00 00 00
00 00 00 00 02 00 02 00 02 00 00 00 00 00 00 00 00 00 00 00 00 00 01 01 01 01 01 00 00 01 01 00 00 03 01 00 00 00 00 00 01 01 01 00 00 00 00 00 00 00
00 00 00 00 00 02 00 02 00 02 00 00 00 00 00 02 00 00 00 02 00 00 01 01 01 01 01 00 00 01 00 00 00 00 01 00 00 00 02 00 01 01 01 00 00 00 00 00 00 00
00 00 00 01 01 01 01 01 01 01 01 00 02 01 01 01 00 00 01 01 00 06 00 00 00 00 00 00 00 00 00 00 00 00 00 00 00 02 00 00 01 01 00 00 00 00 00 00 00 00
00 00 00 04 04 04 04 04 04 04 04 00 00 01 01 04 00 00 01 01 00 00 00 00 06 00 00 00 00 02 00 00 00 00 00 00 00 00 00 00 01 01 00 00 00 00 00 00 02 00
00 00 00 01 01 01 01 01 01 01 01 00 00 01 01 01 02 02 01 01 01 01 01 01 01 01 01 00 00 02 00 00 00 00 00 00 00 00 00 00 00 01 07 00 00 00 00 00 00 00
00 00 00 00 00 00 00 00 00 02 00 00 00 01 01 01 02 02 01 01 01 01 01 01 00 00 00 00 00 00 00 00 00 02 00 02 00 00 00 00 00 00 07 00 00 00 02 00 00 00
00 00 00 00 00 00 00 00 00 00 00 00 00 01 01 04 00 00 00 00 00 00 00 00 02 00 02 08 00 06 00 00 00 02 00 00 00 00 00 00 00 00 07 00 00 02 00 00 00 01
00 00 00 00 00 00 01 01 00 00 00 00 00 01 01 04 00 00 00 00 00 00 00 00 00 00 00 08 00 00 06 00 00 00 00 00 00 00 00 00 00 00 07 00 00 00 00 00 01 01
01 01 01 01 01 01 01 01 01 01 01 01 01 01 01 01 00 00 01 01 01 01 01 01 01 01 01 01 00 00 00 00 00 00 00 00 00 00 00 00 00 00 07 00 00 00 01 01 01 01
00 00 00 00 00 00 00 00 00 00 00 00 00 00 00 00 00 00 00 00 00 00 00 00 00 00 00 00 00 00 00 00 03 00 00 00 00 01 00 00 00 00 00 00 00 00 00 00 09 00