00 01 01 01 00 01 00 02 00 01 01 01 01 01 12 00 00 00 00 00 10 00 00 01 04 01 01 01 01 00 00 10 10 03 01 01 01 01 01 00 00 01 01 01 01 00 00 00 01 00
00 01 01 02 00 00 00 00 00 00 00 00 06 06 00 00 00 06 06 06 00 00 00 00 00 00 01 01 01 00 00 00 00 03 00 01 01 00 00 00 00 00 01 01 00 02 00 00 00 00
00 00 01 02 00 00 00 00 00 00 00 00 06 06 00 00 00 06 06 06 00 00 00 00 00 00 00 01 01 00 00 00 00 00 00 01 00 00 00 02 02 00 00 01 02 00 01 01 00 00
00 00 01 02 00 00 00 00 01 00 02 00 06 06 00 00 02 00 00 00 00 00 00 00 00 00 00 00 01 00 00 13 00 00 00 01 00 00 00 00 00 00 00 01 00 00 03 00 00 02
00 00 01 01 01 00 00 00 01 00 00 00 06 06 00 02 02 00 00 00 00 00 02 02 00 00 00 00 02 00 00 00 11 00 00 00 00 00 00 00 00 00 00 00 00 00 00 00 02 00
00 00 01 01 01 01 01 00 00 01 00 00 06 06 00 02 06 00 06 02 02 00 02 02 00 00 00 00 02 00 00 00 13 00 00 00 00 00 00 00 00 00 00 00 00 00 00 00 00 00
00 00 00 03 01 01 01 00 00 01 00 00 00 00 00 00 06 00 06 00 00 00 00 00 00 00 00 00 01 00 00 11 00 00 00 00 02 00 00 00 00 00 00 00 00 00 00 00 00 00
00 00 00 00 00 00 01 00 00 01 02 00 02 02 00 06 00 02 00 06 00 00 00 00 00 00 00 01 01 00 00 00 00 00 00 02 00 00 00 00 00 00 00 00 00 00 02 00 00 00
00 02 00 00 00 02 00 00 00 01 05 02 00 00 00 06 00 02 00 06 00 00 00 00 00 00 01 01 01 00 00 00 00 04 00 00 00 02 02 02 02 00 00 00 02 00 00 00 00 00
00 00 00 02 00 00 00 00 01 01 01 04 04 01 12 00 00 00 00 00 10 00 00 04 01 01 01 01 01 00 00 10 10 01 00 00 00 00 00 04 04 01 01 01 00 00 04 00 00 01
00 00 00 00 00 00 00 00 00 00 00 00 00 00 00 00 00 00 00 00 00 00 00 00 00 00 00 00 00 00 00 00 00 00 00 00 00 00 00 00 00 00 00 00 00 00 00 00 00 00