00 00 00 00 00 00 00 00 00 00 00 00 01 01 01 04 01 01 03 01 01 01 04 01 03 01 01 01 01 01 01 01 01 00 00 00 01 04 00 00 00 04 00 00 00 00 04 00 00 00
00 02 00 06 00 00 00 02 00 06 00 00 00 00 00 00 00 12 00 10 00 00 00 00 00 12 00 10 00 00 00 00 00 00 00 00 00 04 00 00 00 04 00 00 00 00 04 00 00 00
00 02 00 06 00 00 00 02 00 06 00 00 00 00 00 00 00 12 00 10 00 00 00 00 00 12 00 10 00 00 00 00 00 00 00 00 00 04 00 00 00 04 00 00 00 00 01 00 00 00
00 02 00 06 00 00 00 06 00 02 00 00 00 00 00 00 02 12 00 10 00 00 00 00 00 12 00 00 00 00 10 00 00 00 00 00 00 01 00 00 00 04 00 00 00 02 02 02 00 00
00 06 00 02 00 00 00 06 00 02 00 00 00 00 02 02 02 12 00 00 00 00 10 00 00 12 00 00 00 00 10 00 00 00 00 00 02 02 02 00 00 04 00 00 00 02 02 02 00 00
00 06 00 02 00 00 00 02 00 06 00 00 00 00 02 02 02 12 00 00 00 00 10 00 00 12 00 10 00 00 00 00 00 00 00 00 02 02 02 00 00 01 00 00 00 00 01 00 00 00
00 06 00 02 00 00 00 02 00 06 00 00 00 00 00 00 02 12 00 00 00 00 10 00 00 12 00 10 00 00 00 00 00 00 00 00 00 01 00 00 02 02 02 00 00 00 04 00 00 00
00 02 00 06 00 00 00 06 00 02 00 00 00 00 00 00 00 12 00 10 00 00 00 00 00 12 00 00 00 00 10 00 00 00 00 00 00 04 00 00 02 02 02 00 00 00 04 00 00 00
00 02 00 06 00 00 00 06 00 02 00 00 00 00 00 00 00 12 00 10 00 00 00 00 00 12 00 00 00 00 10 00 00 00 00 00 00 04 00 00 00 01 00 00 00 00 04 00 00 00
00 02 00 06 00 00 00 02 00 06 00 00 00 00 00 00 00 12 00 10 00 00 00 00 00 12 00 10 00 00 00 00 00 00 00 00 01 01 00 00 00 04 00 00 00 00 04 00 00 00
00 00 00 00 00 00 00 00 00 00 00 00 00 00 00 00 00 00 00 00 00 00 00 00 00 00 00 00 00 00 00 00 00 00 00 00 00 00 00 00 00 00 00 00 00 00 00 00 00 00