01 01 01 13 13 10 10 13 13 10 10 00 00 00 00 01 00 00 00 00 01 03 00 00 00 03 01 00 00 00 00 00 01 01 00 01 01 13 10 13 10 00 01 00 00 00 00 00 01 00
00 00 00 00 00 11 11 13 13 11 11 00 00 00 00 06 00 00 00 00 00 06 00 00 00 00 06 00 00 00 00 00 00 00 00 00 00 13 11 13 11 00 00 06 00 00 00 00 00 00
00 00 00 00 00 11 11 13 13 11 11 00 00 00 00 06 00 00 00 00 00 06 00 00 00 00 06 00 00 00 00 00 00 00 00 00 00 13 11 13 11 00 00 06 00 00 00 00 00 00
00 02 02 13 13 11 11 00 00 11 11 00 00 00 00 06 00 00 00 00 00 06 00 00 00 00 06 00 00 00 00 00 00 00 00 00 00 13 11 00 11 00 00 00 06 00 00 00 00 06
00 02 02 13 13 11 11 00 00 11 11 00 00 02 02 02 02 02 02 02 02 02 02 02 02 02 02 00 00 00 00 00 00 00 00 00 00 00 11 00 11 00 02 02 06 00 02 02 00 06
00 02 02 13 13 11 11 13 13 00 00 00 00 02 02 02 02 02 02 02 02 02 02 02 02 02 02 00 00 00 00 00 00 00 00 00 00 00 00 13 00 00 02 02 00 06 02 02 06 00
00 00 00 13 13 00 00 13 13 00 00 00 00 06 00 00 00 00 06 00 00 00 00 06 00 00 00 00 00 06 00 00 00 00 00 00 00 13 00 13 00 00 00 00 00 06 00 00 06 00
00 00 00 13 13 00 00 13 13 11 11 00 00 06 00 00 00 00 06 00 00 00 00 06 00 00 00 00 00 06 00 00 00 00 00 00 00 13 11 13 11 00 00 00 00 00 00 06 00 00
00 00 00 13 13 11 11 13 13 11 11 00 00 06 00 00 00 00 06 00 00 00 00 06 00 00 00 00 00 06 00 00 00 00 00 00 00 13 11 13 11 00 00 00 00 00 00 06 00 00
01 01 01 10 10 11 11 10 10 11 11 00 00 01 00 00 00 00 01 00 00 00 00 01 00 00 00 00 01 00 00 00 00 00 00 01 01 10 11 10 11 00 00 00 00 01 00 00 00 00
00 07 00 00 00 00 00 00 00 00 00 00 00 00 00 00 00 00 00 00 00 00 00 00 00 00 00 00 00 00 00 00 00 00 00 00 00 00 00 00 00 00 00 00 00 00 00 00 09 00