1111111111111111111111111
0000000001111111111111111
0000000001111111100011111
0002000201111110000000111
0000010001111000000000001
0200110000000002000000000
0000110000000000001000000
0001110200020000111110020
0111110000000011111111000
1111111111111111111111111