1411111114111111111111111
0000000000000011111111111
0200020002000011111111111
0000000000000041111111111
0000000000022001111111111
1111114111002200000000000
1111111111100000000000000
1111111111100002000200020
1111111111100000000000000
1111111111111111111114111