1111111111111111111111111
0111001110000000116211100
0111201100000000010011100
0010000100000000010011000
0010000000001020000001000
0010000000201000000001200
0000000000001000000000000
0000001200011000020000000
0000011000011100000000000
1111111111111111111111111