1111111111111111111111111
1111100011111111100011111
1140000000411140000000411
1000022200001000022200001
0002000002000002000002000
2000004000002000004000002
0000411140000000411140000
0011111111100011111111100
1111111111111111111111111
1111111111111111111111111