1310000006000000114300000
0000000000000000000600000
0020000000000000020000000
0000000000113000000000000
0400000000000000000020000
0100000000020000000000000
0110020000000020000000220
1110000020000000000000000
1110000000000011000004114
1110004110000000000000000