12 0 0 0 12 0 0 0 12 0 0 0 12 0 0 0 12 0 0 0 0 0 0 10 4 1 1 1 1 1 1 1 1 1 1 1 1 1 1 1 1 1 1 1 1 1 1 1 1 1
0 0 0 0 0 0 0 0 0 0 0 0 0 0 0 0 0 0 0 0 0 0 0 10 4 1 1 1 1 1 1 1 1 1 0 0 3 1 1 1 1 3 1 1 1 1 1 1 0 0
0 0 0 0 0 0 0 0 0 0 0 0 0 0 0 0 0 0 0 0 0 0 0 0 4 1 1 1 1 0 0 1 1 0 0 0 0 0 1 1 1 0 0 0 1 1 1 1 0 0
0 0 2 2 0 0 2 2 0 0 2 2 0 0 2 2 0 0 2 2 0 0 0 0 1 0 3 1 0 0 0 3 1 0 0 0 0 0 0 1 0 0 0 0 0 3 1 0 0 0
0 0 0 0 0 0 0 0 0 0 0 0 0 0 0 0 0 0 0 0 0 0 0 13 0 0 0 0 0 2 0 0 1 0 0 2 0 0 0 0 0 0 2 0 0 0 4 0 0 0
6 6 6 6 6 6 6 6 6 6 6 6 6 6 6 6 6 6 6 6 0 0 0 11 0 2 0 0 0 0 0 0 0 0 0 0 2 0 0 0 0 0 0 2 0 0 0 0 0 0
2 2 0 0 2 2 0 0 2 2 0 0 2 2 0 0 2 2 0 0 0 0 0 0 1 0 0 0 4 0 0 2 2 0 0 1 0 0 0 2 0 0 1 0 0 0 0 2 2 0
0 0 0 0 0 0 0 0 0 0 0 0 0 0 0 0 0 0 0 0 0 0 0 0 4 0 0 1 1 0 0 0 0 0 0 1 0 0 0 0 0 1 1 0 0 0 0 0 0 1
0 0 0 0 0 0 0 0 0 0 0 0 0 0 0 0 0 0 0 0 0 0 0 10 4 0 0 1 1 1 0 0 0 0 1 1 1 0 0 0 0 1 1 5 0 0 0 0 4 1
0 0 12 0 0 0 12 0 0 0 12 0 0 0 12 0 0 0 12 0 0 0 0 10 4 1 1 1 1 1 1 1 1 4 1 1 1 1 4 4 1 1 1 1 1 1 1 1 1 1