1111111114111111111111111
3411111003411111001111111
0344110000314110004141111
0003000220003000200435110
0006000000006000000001000
0000000000000000002006000
0000220000022000002200000
0000000000000000000002200
0220004444000222001100000
0000111111110000011110000