1111111111111111111411111
0111000000000000000000000
0111020002000020200020020
0010004000000000000000000
0040000000000004111002000
0010000000000000000114111
0000000014002000000000000
0200000111100000000000020
0000000111100002000200000
0000000011000411000000000