1111111111111133111111111
0000114410000000000001111
0000003000000000000000341
0000000000220000002200031
0200000022000000000020000
0000000000000011000002000
0011400000001111440000220
0111111000011111111100000
1111111111111111111110000
1111111111111111111111111