1111111111111111111111111
0000111110000000000001111
0000001000000200000000111
0200000000002000002200000
0000000000000000000000000
0000000000000011000000200
0011100022001111110000000
0111111000011111111100000
1111111111111111111110000
1111111111111111111111111