1111111111111111111111111
0000000000000011111111111
0000000000000211111111111
1111111111120011111111111
1111111111100211111111111
1111111111120011111111111
1111111111100211111111111
1111111111120000000000000
1111111111100000000000000
1111111111111111111111111