1111111111111111111111111
1111100011111111100011111
1110000000111110000000111
1000002000001000002000001
0002000002000002000002000
2000001000002000001000002
0000111110000000111110000
0011111111100011111111100
1111111111111111111111111
1111111111111111111111111