1114111111111111114111111
0000000111111110000000111
0002000111111110020000411
0000020041111420000020204
0200002000110002000000000
0001400000000000001000200
0011100002020000011400000
0011114000000004411100000
0111111410000111111110000
1111111111111111111111111