1141111111111111111111111
0000000001111111111111111
0000000201111111100011111
0002000004111140000000111
0000010001411000200020004
0200440200000000000000000
0000110000000200004000020
0001110000200000111110000
0111140000000011111110000
1111111111114111111111111