1111111111111111111111111
1111111110001111111111111
1111111100000111111111111
0111111000200011111111111
0111110000000001111111111
0011000200100200111111111
0000000000110000000000000
0002000001111002000020000
0000000011111100000000000
1111111111111111111111111