1111111111111111111111111
0111000000000000000001110
0111000020005000200001110
0010020000000000000200100
0000000010000000100000000
0000000001100011000000000
0020002000011100002000200
0000000000000000000000000
0000000000020200000000000
1111111111000001111111111