0111100014000000000000110
0341100000000011000001111
0000002200000111100004311
0000000000200431100200000
0000000110000000000200000
0022004111002000000022020
0022003111002000000000020
0000000000000000220041000
0000000200200110000111100
1100200000004111000111100