1310040013100400313004000
2220040022200400222004000
0600040006000400060004000
0000040000000400000004000
0002000200020002000200000
0002000200020002000200000
0400000004000000040000000
0400000004000000040000000
0400222004002220040022200
0400411004001410040041400