1111111111111111111111111
0011100000000000000000000
0011102000020200000002000
0001000000000000000000000
0000000000100010000011110
0002000001111111000011110
0000000001111111000000000
0000000011111111100002000
0011100011111111100000000
1111111111111111111000000