1111111111111144111111111
0000111110000000000001111
0000004000000000000000411
0000000000000022000200011
0200000000220000000020000
0000000000000011000000000
0011400022001111440000220
0111111000011111111100000
1111111444411111111110000
1111111111111111111111111