1 1 1 1 1 1 1 1 1 1 1 1 3 3 1 1 1 1 1 1 1 1 1 1 1 1 1 1 1 1 3 1 1 1 1 1 1 3 1 1 1 1 1 1 1 3 1 1 1 1
0 1 1 1 0 0 0 0 1 1 1 1 13 13 0 0 0 1 1 1 1 1 1 1 1 0 0 1 0 0 0 0 1 0 0 0 0 0 0 0 0 0 0 0 0 0 0 0 0 0
0 1 1 1 0 5 0 0 0 1 1 1 0 0 0 0 0 0 1 1 0 3 1 1 0 0 0 6 0 0 0 0 0 0 0 0 2 0 0 0 0 2 2 0 0 0 0 2 2 0
0 0 1 1 0 0 0 0 0 4 1 0 0 0 0 0 0 0 1 1 0 0 1 4 0 0 0 0 2 0 0 0 0 0 0 0 0 0 0 0 0 0 0 0 0 0 0 0 0 0
0 0 1 0 0 0 0 0 0 1 0 0 0 0 5 0 0 0 4 0 0 0 1 0 0 0 0 0 0 0 0 0 2 0 0 1 1 1 4 1 1 1 1 1 1 1 1 1 4 1
0 0 1 0 0 0 0 0 0 1 0 0 0 0 0 0 0 0 1 0 0 0 0 0 0 0 0 0 0 0 0 0 0 0 0 0 1 3 1 1 1 1 3 1 0 0 1 1 1 0
0 0 6 0 0 0 0 0 0 6 0 0 0 0 0 0 0 0 1 0 0 0 0 0 0 2 0 0 4 1 0 0 0 0 0 0 0 0 0 0 0 0 0 0 0 0 0 0 0 0
0 0 0 0 0 0 0 0 0 0 0 0 0 0 0 0 0 0 6 0 0 0 0 0 0 0 0 0 1 1 1 0 0 0 0 0 2 2 2 0 0 0 2 2 2 0 0 2 2 2
0 2 0 0 2 0 0 0 2 0 0 2 0 0 0 2 0 0 0 2 0 2 0 0 0 0 0 1 1 1 1 1 0 0 0 0 0 0 0 0 0 0 0 0 0 0 0 0 0 0
0 0 0 0 0 0 0 0 0 0 0 0 0 0 0 0 0 0 0 0 0 0 0 0 0 0 0 1 1 1 1 1 1 1 1 12 0 0 0 0 0 0 0 0 0 0 0 0 0 10