1111111111111111111111111
1343111343111343111343111
0010000010000010000010000
0030000030000030000030000
0020220020220020220020220
0220020220020220020220020
0000040000040000040000040
0000010000010000010000011
1114411114411114411114411
1111111111111111111111111