0111100011000000000000110
0111100000000011000001111
0000002200000111100001111
0000000000000111100200000
0000000110000000000200000
0020001111002000000000020
0000001111002000000000020
0000000000000000220011000
0000000000200110000111100
1100200000001111000111100