1110040011100400111004000
0600040006000400060004000
0000040000000400000004000
0000040000000400000004000
0002000202020002020200000
0002000202020002020200000
0400000004000000040000000
0400000004000000040000000
0400000004000000040000000
0400411004001410040011400