1114111111111111114111111
0000000111111110002000111
0000020111111110000002411
0001000041111420000000204
0001000000110000001000000
0021120000000000001000000
0011100000000000011400000
0011114000000004411100000
0111111412002111111112000
1111111111111111111111111