1 1 1 1 1 1 1 1 1 4 1 1 1 1 1 1 1 1 1 1 1 1 1 1 1 1 1 1 1 1 1 1 1 1 1 1 1 1 13 13 13 13 13 13 13 13 13 13 13 13
1 1 1 1 1 1 1 0 0 0 0 0 1 1 1 1 1 1 1 1 0 0 0 0 0 0 0 1 1 1 1 1 1 1 1 1 1 1 0 0 0 0 0 0 0 0 0 0 0 0
0 1 1 1 1 1 0 0 0 0 0 0 3 1 1 1 1 1 1 0 0 2 2 0 0 0 0 1 1 1 1 1 1 1 1 1 3 0 0 0 0 0 0 0 0 0 0 10 0 0
0 0 1 4 0 0 0 2 2 0 0 0 0 1 1 1 1 0 0 2 2 0 0 0 0 0 0 3 1 1 1 1 1 1 3 1 0 0 0 0 10 10 0 10 10 10 10 1 10 10
0 0 0 0 0 0 2 0 0 0 0 0 0 1 1 1 0 0 2 0 0 0 0 1 0 0 0 1 1 1 1 4 1 1 0 0 0 0 10 10 0 2 10 0 2 2 0 0 2 0
0 2 2 0 0 0 0 0 0 1 0 2 0 0 3 0 0 0 0 0 0 0 0 1 0 2 0 0 0 0 0 0 0 0 0 0 0 0 0 2 0 1 0 10 10 10 10 10 0 0
0 0 0 0 0 0 1 1 1 1 0 0 2 0 0 0 0 0 0 0 0 0 1 1 0 0 0 0 0 0 0 0 0 0 0 0 2 0 10 10 10 10 10 0 0 0 0 0 10 10
0 0 0 0 0 1 1 1 1 1 1 0 0 2 0 0 0 0 0 0 4 1 1 1 1 0 0 0 0 0 0 2 2 0 0 0 0 0 0 0 0 0 0 0 0 0 0 0 0 0
0 0 1 1 1 1 1 1 1 1 1 1 0 0 0 0 0 0 0 1 1 1 1 1 1 1 1 0 0 0 0 0 0 0 0 0 0 0 0 0 0 0 0 0 0 0 0 0 0 0
1 1 1 1 1 1 1 1 1 1 1 1 1 0 0 0 0 4 1 1 1 1 1 1 1 1 1 1 1 1 1 1 1 1 1 1 4 1 11 11 11 11 11 11 11 11 11 11 11 11
0 0 0 0 0 0 0 0 0 0 0 0 0 0 0 0 0 0 0 0 0 0 0 0 0 0 0 0 0 0 0 0 0 0 0 0 0 0 0 0 0 0 0 0 0 0 0 0 0 0