1111111114111111111111111
1111111110001111111111111
1111111100000411111111111
0111114000200011111111111
0111110020000001111111111
0041000000100200111141111
0000000200110000000000000
0200200004111000200020002
0000000011111100000000000
1114111111111141111111111