1111111111111111111111111
1111111110201111111111111
1111111100000111111111111
0111111200000211111111111
0111110000100001111111111
0011200000110002111111111
0000000001111000011111111
0000000011111100000000000
0000001111111110000002000
1111111111111111111111111