1111111111144111111111111
0111001110022000116211100
0111201100000000010011100
0010002400000000040041000
0010000000001020020004000
0040000000201000000001200
0000000000004000000000000
0000001200041000020000000
0000011000011100000000000
1111111144111111441111141