1111113111111111113111111
1111100031111111100031111
1140000000411140000000411
1000022200003000022200001
0002000002000002000002000
2200004000002000004000022
0000411140000000411140000
0011111111100011111111100
1111111111111111111111111
1111111111111111111111111