1111111111111111111111111
0111000000000000000000000
0111020000000020200020020
0010001000000111110000000
0010000000000000001000000
0010000000000000000111111
0000000011002000000000000
0200000111100000000000000
0000000111100002000200000
0000000011000111000000000