1111111111111111111111111
0600000060000006000006000
0002020200200200020020020
0000000000000000000000000
0000000000000000000000000
0000000011000001000000000
0100000111000001000001100
1110001111000011000011100
1110001111100011100011100
1111111111111111111111111