1110040011100400111004000
0600040006000400060004000
0000040000000400000004000
0000040000000400000004000
0002000200020002000200000
0002000200020002000200000
0400000004000000040000000
0400000004000000040000000
0400000004000000040000000
0400111004001110040011100