1111111111111111111111111
1411111411111411111411111
0010000010000010000010000
0040000040000040000040000
0020020020020020020020020
0020020020020020020020020
0000010000010000010000010
0000010000010000010000010
4414414414414414414414414
1111111111111111111111111