1114311134113413111134111
0600000060000006000006000
0002020202200220022020020
0000000000000000000000002
0000000010000001000000000
0100200111020001002001000
0100000111000004000001100
1140004111500011000041100
1110004111100011100011100
1111111111111411111111111