1111111111111111111111111
0000000111111110000000111
0000000111111110020020111
0200000011111100000000001
0000002000110000001000000
0001100200000020001000200
0011100000000000011100020
0011111000000001111100000
0111111110000111111110000
1111111111111111111111111