0111100014000000000000110
0311100000000011000001111
0041002200000111100004311
0000000000200411300200310
0000000110000031000200000
0022004111002000000022020
0022003111002000000000020
0000000110000000220041000
0000000200200110000111100
1100200000004111000111100