1111114111111111114111111
0111000000000000000001110
0111000020025200200001110
0040020000000000000200400
0000000010000000100000000
0000000004100014000000000
0020202000011100002020200
0000000000000000000000000
0000000000022200000000000
1111111111000001111111111