1143111331111111111111111
0000000001111111113311111
0000020001111111100011111
0020000004111140000000131
0000010201411000002000004
0200440000000002000000000
0000110000000200004002000
0001110020020000111110002
0111140000000011111111000
1111111111114111111111111