1111131111331111111411111
0111000000000000000000000
0111020002020020200020020
0010004000000000000000000
0040000200000004311002000
0010200000000000000114331
0000000014002000000000000
0200000111100000000000020
0000000111100002020200000
0000000011000411000000001