1113111111111113111311111
0000000111111110000000111
0000000144111110002000341
0220020033111400000000003
0000002000130002200002000
0001400200000000004000200
0011100000220000011400020
0011114000000004411100000
0111111410000111111110000
1111111111111111111111111