1111111111111111111111111
1111111111111111111111111
0010000010000010000010000
0010000010000010000010000
0000020000020000020000020
0020000020000020000020000
0000010000010000010000010
0000010000010000010000010
1111111111111111111111111
1111111111111111111111111