1111111114114111111111111
4111111110003411111111111
3411111100000411111111111
0111114000220014111111111
0114110020000203411111111
0043000000100000341141111
0000002000110020000000000
0200220004111000020002002
0000000011111100000000000
1114111111111141111111111