1111141311133311131411111
0111000000000000000001110
0111000202025202020003110
0040020000000000000200400
0000000010000000100000000
0000000004100014000000000
0020020000011100000200200
0000000020000000200000000
0000000000022200000000000
1111111111000001111111111